1111111
100C001
11P0111
10000E1
1C0001
1111111
