1111111
100C001
11P0111
10000E1
1C00011
1111111
